"filename", "language", "JavaScript", "HTML", "PostCSS", "JSON", "Properties", "comment", "blank", "total"
"/home/jadhu/projects/Demo_Project/bhutanchoice.com/agent/.env", "Properties", 0, 0, 0, 0, -4, 0, 0, -4
"/home/jadhu/projects/Demo_Project/bhutanchoice.com/agent/app.js", "JavaScript", -44, 0, 0, 0, 0, -6, -13, -63
"/home/jadhu/projects/Demo_Project/bhutanchoice.com/agent/config/connection.js", "JavaScript", -17, 0, 0, 0, 0, 0, -4, -21
"/home/jadhu/projects/Demo_Project/bhutanchoice.com/agent/helper/agentAuthHelper.js", "JavaScript", -58, 0, 0, 0, 0, -5, -16, -79
"/home/jadhu/projects/Demo_Project/bhutanchoice.com/agent/helper/agentHelper.js", "JavaScript", -265, 0, 0, 0, 0, -18, -47, -330
"/home/jadhu/projects/Demo_Project/bhutanchoice.com/agent/helper/bookingHelper copy.js", "JavaScript", -14, 0, 0, 0, 0, 0, -6, -20
"/home/jadhu/projects/Demo_Project/bhutanchoice.com/agent/helper/bookingHelper.js", "JavaScript", -421, 0, 0, 0, 0, -155, -89, -665
"/home/jadhu/projects/Demo_Project/bhutanchoice.com/agent/helper/indexHelper.js", "JavaScript", -930, 0, 0, 0, 0, -81, -116, -1127
"/home/jadhu/projects/Demo_Project/bhutanchoice.com/agent/helper/settingHelper.js", "JavaScript", -118, 0, 0, 0, 0, -3, -20, -141
"/home/jadhu/projects/Demo_Project/bhutanchoice.com/agent/helper/startingHelper.js", "JavaScript", -741, 0, 0, 0, 0, -589, -4, -1334
"/home/jadhu/projects/Demo_Project/bhutanchoice.com/agent/helper/verifyAgent.js", "JavaScript", -26, 0, 0, 0, 0, -6, -6, -38
"/home/jadhu/projects/Demo_Project/bhutanchoice.com/agent/model/adminSchema.js", "JavaScript", -33, 0, 0, 0, 0, 0, -4, -37
"/home/jadhu/projects/Demo_Project/bhutanchoice.com/agent/model/agentSchema.js", "JavaScript", -60, 0, 0, 0, 0, -1, -8, -69
"/home/jadhu/projects/Demo_Project/bhutanchoice.com/agent/model/bookingsSchema.js", "JavaScript", -174, 0, 0, 0, 0, -10, -12, -196
"/home/jadhu/projects/Demo_Project/bhutanchoice.com/agent/model/lotterySchema.js", "JavaScript", -59, 0, 0, 0, 0, -5, -9, -73
"/home/jadhu/projects/Demo_Project/bhutanchoice.com/agent/model/seoSchema.js", "JavaScript", -24, 0, 0, 0, 0, -3, -3, -30
"/home/jadhu/projects/Demo_Project/bhutanchoice.com/agent/model/ticketChargeSchema.js", "JavaScript", -8, 0, 0, 0, 0, -1, -3, -12
"/home/jadhu/projects/Demo_Project/bhutanchoice.com/agent/nodemon.json", "JSON", 0, 0, 0, -16, 0, 0, 0, -16
"/home/jadhu/projects/Demo_Project/bhutanchoice.com/agent/package.json", "JSON", 0, 0, 0, -24, 0, 0, -1, -25
"/home/jadhu/projects/Demo_Project/bhutanchoice.com/agent/public/stylesheets/style.css", "PostCSS", 0, 0, -7, 0, 0, 0, -2, -9
"/home/jadhu/projects/Demo_Project/bhutanchoice.com/agent/routes/adminAuth.js", "JavaScript", -15, 0, 0, 0, 0, -1, -4, -20
"/home/jadhu/projects/Demo_Project/bhutanchoice.com/agent/routes/agent.js", "JavaScript", -24, 0, 0, 0, 0, -6, -7, -37
"/home/jadhu/projects/Demo_Project/bhutanchoice.com/agent/routes/bookings.js", "JavaScript", -182, 0, 0, 0, 0, -11, -16, -209
"/home/jadhu/projects/Demo_Project/bhutanchoice.com/agent/routes/index.js", "JavaScript", -244, 0, 0, 0, 0, -58, -89, -391
"/home/jadhu/projects/Demo_Project/bhutanchoice.com/agent/routes/settings.js", "JavaScript", -14, 0, 0, 0, 0, -8, -6, -28
"/home/jadhu/projects/Demo_Project/bhutanchoice.com/agent/views/error.ejs", "HTML", 0, -336, 0, 0, 0, -23, -51, -410
"/home/jadhu/projects/Demo_Project/bhutanchoice.com/agent/views/index.ejs", "HTML", 0, -1135, 0, 0, 0, -32, -232, -1399
"/home/jadhu/projects/Demo_Project/bhutanchoice.com/agent/views/pages/Auth/agent-login.ejs", "HTML", 0, -619, 0, 0, 0, -2, -100, -721
"/home/jadhu/projects/Demo_Project/bhutanchoice.com/agent/views/pages/agent/listing.ejs", "HTML", 0, -1538, 0, 0, 0, -15, -254, -1807
"/home/jadhu/projects/Demo_Project/bhutanchoice.com/agent/views/pages/booking/listing.ejs", "HTML", 0, -1448, 0, 0, 0, -17, -219, -1684
"/home/jadhu/projects/Demo_Project/bhutanchoice.com/agent/views/pages/lottery-booking.ejs", "HTML", 0, -1983, 0, 0, 0, -36, -346, -2365
"/home/jadhu/projects/Demo_Project/bhutanchoice.com/agent/views/pages/settings/metaSettingPartal.ejs", "HTML", 0, -54, 0, 0, 0, -3, -5, -62
"/home/jadhu/projects/Demo_Project/bhutanchoice.com/agent/views/pages/settings/setting copy.ejs", "HTML", 0, -793, 0, 0, 0, -45, -156, -994
"/home/jadhu/projects/Demo_Project/bhutanchoice.com/agent/views/pages/settings/setting.ejs", "HTML", 0, -586, 0, 0, 0, -2, -100, -688
"/home/jadhu/projects/Demo_Project/bhutanchoice.com/agent/views/partials/Edit-create-extention.ejs", "HTML", 0, -1380, 0, 0, 0, -6, -219, -1605
"/home/jadhu/projects/Demo_Project/bhutanchoice.com/agent/views/partials/Footer.ejs", "HTML", 0, -264, 0, 0, 0, -6, -54, -324
"/home/jadhu/projects/Demo_Project/bhutanchoice.com/agent/views/partials/indexScript.ejs", "HTML", 0, -75, 0, 0, 0, 0, -12, -87
"/home/jadhu/projects/Demo_Project/bhutanchoice.com/agent/views/partials/past.ejs", "HTML", 0, -378, 0, 0, 0, -25, -60, -463
"/home/jadhu/projects/Demo_Project/bhutanchoice.com/agent/views/partials/ticketChargeExtention.ejs", "HTML", 0, -789, 0, 0, 0, -8, -140, -937
"/home/jadhu/projects/Demo_Project/bhutanchoice.com/agent/views/partials/todays-results.ejs", "HTML", 0, -248, 0, 0, 0, -13, -33, -294
"/home/jadhu/projects/Demo_Project/bhutanchoice.com/agent/views/partials/upcoming-lotteries.ejs", "HTML", 0, -215, 0, 0, 0, -14, -36, -265
"/home/jadhu/projects/Demo_Project/bhutanchoice.com/agent/views/partials/winning-numbers copy.ejs", "HTML", 0, -169, 0, 0, 0, -1, -33, -203
"/home/jadhu/projects/Demo_Project/bhutanchoice.com/agent/views/partials/winning-numbers.ejs", "HTML", 0, -271, 0, 0, 0, -1, -50, -322
"/home/jadhu/projects/Demo_Project/bhutanchoice.com/agent/views/template.ejs", "HTML", 0, -375, 0, 0, 0, -6, -71, -452
"/home/jadhu/projects/Demo_Project/bhutanchoice.com/client/.env", "Properties", 0, 0, 0, 0, 2, 0, 0, 2
"/home/jadhu/projects/Demo_Project/bhutanchoice.com/client/app.js", "JavaScript", 30, 0, 0, 0, 0, 5, 11, 46
"/home/jadhu/projects/Demo_Project/bhutanchoice.com/client/config/connection.js", "JavaScript", 17, 0, 0, 0, 0, 0, 4, 21
"/home/jadhu/projects/Demo_Project/bhutanchoice.com/client/helper/indexHelper.js", "JavaScript", 162, 0, 0, 0, 0, 13, 33, 208
"/home/jadhu/projects/Demo_Project/bhutanchoice.com/client/helper/startingHelper.js", "JavaScript", 261, 0, 0, 0, 0, 729, 6, 996
"/home/jadhu/projects/Demo_Project/bhutanchoice.com/client/model/lotterySchema.js", "JavaScript", 58, 0, 0, 0, 0, 0, 9, 67
"/home/jadhu/projects/Demo_Project/bhutanchoice.com/client/nodemon.json", "JSON", 0, 0, 0, 16, 0, 0, 0, 16
"/home/jadhu/projects/Demo_Project/bhutanchoice.com/client/public/stylesheets/style.css", "PostCSS", 0, 0, 7, 0, 0, 0, 2, 9
"/home/jadhu/projects/Demo_Project/bhutanchoice.com/client/routes/index.js", "JavaScript", 24, 0, 0, 0, 0, 1, 7, 32
"/home/jadhu/projects/Demo_Project/bhutanchoice.com/client/routes/users.js", "JavaScript", 27, 0, 0, 0, 0, 0, 8, 35
"/home/jadhu/projects/Demo_Project/bhutanchoice.com/client/views/checkTime.ejs", "HTML", 0, 66, 0, 0, 0, 11, 10, 87
"/home/jadhu/projects/Demo_Project/bhutanchoice.com/client/views/error.ejs", "HTML", 0, 339, 0, 0, 0, 23, 49, 411
"/home/jadhu/projects/Demo_Project/bhutanchoice.com/client/views/index.ejs", "HTML", 0, 876, 0, 0, 0, 14, 187, 1077
"/home/jadhu/projects/Demo_Project/bhutanchoice.com/client/views/partials/Edit-create-extention.ejs", "HTML", 0, 1020, 0, 0, 0, 6, 169, 1195
"/home/jadhu/projects/Demo_Project/bhutanchoice.com/client/views/partials/indexScript.ejs", "HTML", 0, 75, 0, 0, 0, 0, 12, 87
"/home/jadhu/projects/Demo_Project/bhutanchoice.com/client/views/partials/past copy.ejs", "HTML", 0, 194, 0, 0, 0, 36, 35, 265
"/home/jadhu/projects/Demo_Project/bhutanchoice.com/client/views/partials/past.ejs", "HTML", 0, 239, 0, 0, 0, 12, 35, 286
"/home/jadhu/projects/Demo_Project/bhutanchoice.com/client/views/partials/pastNeed.ejs", "HTML", 0, 57, 0, 0, 0, 1, 7, 65
"/home/jadhu/projects/Demo_Project/bhutanchoice.com/client/views/partials/todays-results.ejs", "HTML", 0, 248, 0, 0, 0, 13, 33, 294
"/home/jadhu/projects/Demo_Project/bhutanchoice.com/client/views/partials/upcoming-lotteries copy.ejs", "HTML", 0, 82, 0, 0, 0, 7, 7, 96
"/home/jadhu/projects/Demo_Project/bhutanchoice.com/client/views/partials/upcoming-lotteries.ejs", "HTML", 0, 205, 0, 0, 0, 13, 36, 254
"/home/jadhu/projects/Demo_Project/bhutanchoice.com/client/views/partials/winning-numbers.ejs", "HTML", 0, 271, 0, 0, 0, 1, 49, 321
"Total", "-", -2892, -8984, 0, -24, -2, -337, -1947, -14186